2 13 15 1
###############
#  p          #
# # # # # # # #
#  *********  #
#*# # # # #*# #
#  * ** ****  #
#1#*#*# #2#*#1#
#  * ** ****  # 
# #*# # # #*# #
#  *********  #
# # # #*# # # #
#1     2     1#
###############
x 10 7