2 13 31 4
###############################
#  p  ******************      #
# # # # # # # # # # # # # # # #
#  *****  2    *   2   *****  #
# #*#*# # # # # # # # # #*#*# #
#    *****  3     3  *****    #
# # # # # # # # # # # # # # # #
#   2  ****    1    ****  2   #
# # # # #*#*# # # #*#*# # # # #
#      1   **     **   1      #
# # # # # # # #*# # # # # # # #
# 1         3     3        1  #
###############################
x 1 1
f 1 8
b 3 3
s 3 15