1 13 31 6
###############################
# p    ** *1   * 1 *  * * *  1#
# # # #*# # #*#*# # # #*#*#*# #
#   *   1 * *  *  1   * 1 * * #
# # # # # #*# # #*#*# # # # #*#
#    1       **  *  *   1     #
# # # # # # # # 1 #*# #*# # # #
#*  *   1  *  *  1   *  2     #
# # # # #*# # # #*#*# # # # # #
#*    **  * 1     *      1    #
# #*# # # # # # #*# # # # # # #
#     1     *   *  *          #
###############################
s 1 7
b 1 8
f 2 7
s 7 14
b 11 16
x 3 4